0000000000000
10010000000C0
1000011111000
1P0011E000000
0000000000000