1111111111111
10010000000C1
1Z00011111001
1P0011E000001
1111111111111